R 1000 600
NO ./textures/wall_n.xpm
SO ./textures/wall_s.xpm
WE ./textures/wall_w.xpm
EA ./textures/wall_e.xpm

S ./textures/sprite.xpm

F 200,200,200
C 250,250,250

        1111111111111111111111111
        1000000000000000000000001
        1000000000000000000000001
        1000000000000000000000001
        1000000000000000000000001
        1000000000000000000000001
        1000000000000000000000001
        1000000000000000000000001
        1000000000000000000000001
        1000000000000000000000001
        1000000000000000000000001
        1000000000000000000000001
        1222222222222222222222221
        1211222222222222222222221
        1221222222222222222222221
111111111211222222222222222222221
122222222211222221222111111111111
11112111111111211122222222221
11112111111111211121212212221
11222222112121211122222212221
12222222222222221122222212221
12222222222222221121212212221
11222221112121211111211112121
11112111 1112121 1211112122S1
11111111 1111111 111111111111
