R 1000 600
NO ./textures/wall_n.xpm
SO ./textures/wall_s.xpm
WE ./textures/wall_w.xpm
EA ./textures/wall_e.xpm

S ./textures/sprite.xpm

F 200,200,200
C 250,250,250

        1111111111111111111111111
        1000000000000000000000001
        1011000000000000002000001
        1001000000200000000200001
111111111011020000000000002000001
100022000011002001000111111111111
11110111111111011120000020001
11110111111111011101010010001
11200020110101011100000010201
10002000200000001100000010201
10000200020002001101010010201
1122000111010101111101111010111
11110111 1110101 1011110100S1
11111111 1111111 111111111111
